+--+--+--+--+--+
aaaaaaaaaaaaaaE|
+b+c+--+--+--+-|
|d+a|--+--+--+-|
+e+f--+--+--+--+
|fgfg-+--+--+--+
+--+h-+--+--+--|
|a+|d+|--|d+bcE|
+a+|e+|E-+d+a++|
|abcdabcdsadsda|
+--+--+--+--+--+